000000000000
011101111110
001000101010
011011001110
010110010000
011101111110
011101000100
001000111110
011011100100
001110111110
011011101010
000000000000
